0, 0, 0, 0, 0, 0, 0, 0, 0, 0.
0, 0, 0, 0, 0, 0, 0, 0, 0, 0.
0, 0, 0, 0, 0, 0, 0, 0, 0, 0.
0, 0, 0, 1, 3, 0, 0, 0, 0, 0.
1, 2, 3, 4, 6, 1, 2, 3, 0, 0.
4, 5, 6, 0, 0, 4, 5, 6, 0, 0.